TTTTTTTTTT
T________T
T________T
T________T
T________T
T________T
T__X_____T
TTTTTTTTTT