_________
_TTTTT___
___T_____
___T_____
_________
__X______