TTTTTTTTT
TTTTTT__T
T__T____T
T__T____T
T_______T
T_X_____T