TTTTTTTTTT
T________T
T___E____T
T_____E__T
T________T
T________T
T__X_____T
TTTTTTTTTT